gameboy -> game boy
videogame -> video game
talkshow -> talk show
pokecenter -> pokemon center
doesn t -> does not
stovetop -> stove top
stovein -> stove in
kung-fu -> kung fu
eachother -> each other
wiffleball -> wiffle ball
seat/stroller -> seat 
stroller/jogger -> stroller
cooldrinks -> cool drinks
runwhile -> run while
oldschool -> old school
anoutdoor -> an outdoor
rock/country -> rock
isn t -> is not 
dragonball -> dragon ball
football/soccer -> football
testdrive -> test drive
c-span2 -> c-span 2
infront -> in front
gameshow -> game show
horror/comedy -> horror
tshirt -> t shirt
racecar -> race car
kitchenthere -> kitchen there
sportscar -> sports car
childs -> child s
movieclips -> movie clips
didn t -> did not
non-english -> non english
webpage -> web page